##############################################
#................G...........................#
#................G...........................#
#................G...........................#
#................G...........................#
#................G...........................#
#................G...........................#
#................G............BBB............#
R................G............BBB............#
#.............................BBB............#
#............................................#
#............................................#
#............................................#
#............................................#
#............................................#
#............................................#
##############################################